5 5 5
0 0 0 0 0
0 0 0 0 0
0 0 0 0 0
0 0 0 0 0
0 0 0 0 0
0 0 0 4 4
0 0 0 4 4
0 0 4 4 4
0 4 4 4 4
4 4 4 4 4
0 0 2 2 4
0 0 2 2 4
0 4 2 9 4
1 4 9 9 4
1 4 4 4 4
2 2 2 2 3
2 2 2 2 3
2 2 2 2 3
2 2 2 3 3
2 2 2 3 1
1 1 1 1 1
1 1 1 1 1
1 1 1 1 1
1 1 1 1 1
1 1 1 1 1
